#0
:0 1 0
RRRRRRRRRRRRRRRRRR..RRRRRRRRRRRRRRRRRRRRRRRRRRRRRRRRR
RRRRRRRRRRRRRRRRRR..RRRRRRRRRRRRRRRRRRRRRRRRRRRRRRRRR
RRRRRRRRRRRRRRRRRR..RRRRRRRRRRRRRRRRRRRRRRRRRRRRRRRRR
RRRRRRRRRRRRRRRRRR..RRRRRRRRRRRRRRRRRRRRRRRRRRRRRRRRR
RRRRRRRRRRRRRRRRRR..RRRRRRRRRRRRRRRRRRRRRRRRRRRRRRRRR
RRRRRRRRRRRRRRRRRR..RRRRRRRRRRRRRRRRRRRRRRRRRRRRRRRRR
RRRRRRRRRRRRRRRR.....................RRRRRRRRRRRRRRRR
RRRRRRRRRRRRRRRR.....................RRRRRRRRRRRRRRRR
RRRRRRRRRRRRRRRR..P..................0RRRRRRRRRRRRRRR
RRRRRRRRRRRRRRRRRRRRR...RR...RR...RRRRRRRRRRRRRRRRRRR
RRRRRRRRRRRRRRRRRRRRR..............RRRRRRRRRRRRRRRRRR
RRRRRRRRRRRRRRRRRRRRRSSSSSSSSSSSSSSRRRRRRRRRRRRRRRRRR
RRRRRRRRRRRRRRRRRRRRRRRRRRRRRRRRRRRRRRRRRRRRRRRRRRRRR
RRRRRRRRRRRRRRRRRRRRRRRRRRRRRRRRRRRRRRRRRRRRRRRRRRRRR
RRRRRRRRRRRRRRRRRRRRRRRRRRRRRRRRRRRRRRRRRRRRRRRRRRRRR
RRRRRRRRRRRRRRRRRRRRRRRRRRRRRRRRRRRRRRRRRRRRRRRRRRRRR
RRRRRRRRRRRRRRRRRRRRRRRRRRRRRRRRRRRRRRRRRRRRRRRRRRRRR
RRRRRRRRRRRRRRRRRRRRRRRRRRRRRRRRRRRRRRRRRRRRRRRRRRRRR;
#1
:0 0 0
RRRRRRRRRRRRRRRRRRRRRRRRRRRRR
RRRRRRRRRRRRRRRRRRRRRRRRRRRRR
RRRRRRRRRRRRRRRRRRRRRRRRRRRRR
RRRRRRRRRRRRRRRRRRRRRRRRRRRRR
RRRR.....................RRRR
RRRR......R....R....R....RRRR
RRRR.....................0RRR
RRRRRRRRR...RR...RR...RRRRRRR
RRRRRRRRR.R....R....R..RRRRRR
RRRRRRRRRSSSSSSSSSSSSSSRRRRRR
RRRRRRRRRRRRRRRRRRRRRRRRRRRRR
RRRRRRRRRRRRRRRRRRRRRRRRRRRRR
RRRRRRRRRRRRRRRRRRRRRRRRRRRRR
RRRRRRRRRRRRRRRRRRRRRRRRRRRRR;